111111111111111
10P010000001001
10001C001001001
1000100010C1001
100000C01001001
1111111110000C1
100000000000001
10E0C010C000001
111111111111111