11111111111111111111111111111111
100000010000C0000000000100000001
1000P001000000000000000100000001
1000111100000001000000010000C001
10001000000000010000000100000001
1000100C000000010000000100000001
10001111111000010000000100000001
100000000000C0010000000100000001
100011111111111100000000000C0001
10001000000000000000000000000001
10001000C00011111111111000000001
10001000000000000000000000000001
1000100000000E000000000000000001
11111111111111111111111111111111