1111111111111111
1P1C00001C000001
1010111010111001
1010100010001001
101010C010001C01
1000100000001001
1111101111111001
1000001000000001
10C0001C00100E01
1111111111111111

