111111111111111111111111111111111111111111111
10P00010000000000000001000C000000000000000001
100000100000000000000010000000000000000000001
100000100000111110000010000011111000001000001
10000010000010000C0000100000E0001000001000001
10000000000011111111111111111111100000100C001
100000000000000000000010000000000000001000001
111111111000000000000010000000100000001000001
100000000000000000000010000000100000001000001
1000000111111111111111100000001000C0000000001
1000C0000000000000000000000000100000000000001
111111111111111111111111111111111111111111111
