11111111111111111
1P1C00001C0000001
10101110101110101
10101000100010101
101010C0100010101
10001000000010101
111110111111101C1
1000001000000C001
10C00010001000E01
11111111111111111

