111111111111111111111111111111
10P0100C000000010C000000000001
100010000000000100000000000001
100010001111000100011110010001
100010001000000100000010010001
10001000100C00010000E010010001
100010001000000100000010010001
10000000111111111111111001C001
100000000000000100000000010001
111111100000000100001000010001
100000000000000100001000010001
10000111111111110000100C000001
10C000000000000000001000000001
10000000000000000000100000C001
111111111111111111111111111111
