1111111111111111111111111
100000010000C000000100001
1000P0010000000000010E001
1000111100000001000100C01
1000100000000001000100001
1000100C00000001000100001
100011111110000100C100001
100000000000C001000100001
1000000000000001000100001
100011111111111100P00C001
1000100000000000000000001
10001000C0011111111000001
1000100000010000000000001
1000100000010E00C00000001
1000100000010000000000001
1111111111111111111111111
