1111111111111111111111
1000P00100000000010E01
10001111000001000100C1
1000100C00000100010001
1000111111100100C10001
100000000000C100010001
1000111111111100P00C01
1000100000000000000001
1000100001111111100001
100010C0010E00C0000001
1111111111111111111111
