111111111111111111
10P001000C00001001
1011110000010010C1
10100C000001001001
1011111100010C1001
100000000C01001001
1111111111110000C1
100000000000000001
100000C01111110001
10E0000010C0000001
111111111111111111
