1111111111111111111
1000100000000010E01
100P100C001000100C1
1001100000100010001
1000000000100C10001
1111111111100010001
1000000000000P00C01
100C001111110000001
1000001000000000001
100C0010E00C0000001
1111111111111111111
