11111111111111111111111111111111111111111
1000000010000C000000000000000100000000001
10000P00100000000000000000000100000000001
1000011110000000000100000000010000C000001
10000100000000000001000000000100000000001
10000100C00000000001000000000100000000001
10000111111100000001000000000100000000001
1000000000000C000001000000000100000000001
100001111111111111110000000000000C0000000
10000100000000000000000000000000000000001
100001000C0001111111111111111000000000001
10000100000000000E00000000000000000000001
11111111111111111111111111111110111111111